%%%%%%%%%%%%%%%%%%%%%%%%%%%%%%%%%%%%%%%%%%%%%%%%%%%%%%%%%%%%%%%%%%%%%%%%%%%%%%%%%%%%%%%%%%%%%%%%%%%%%
%P    % % % %     %   %     %   %   % %   % % %   % %       %   %   % %   % %   %       %           %
%%% %%% % % % % %%% %%%%% %%% %%%%% % % % % % %%% % % %%%%%%% %%% %%% % %%% %%% %%%%% %%%%% %%%%%%% %
%     % % %   %   %                     %     %       % % %   % %                   % % %   %       %
% %%% % % % %%%%% %%% %%%%%%% %%% %%%%% % % %%% %%%%% % % %%% % %%% % % % %%%%%%%%% % % %%% %%% %%%%%
% %         %       %   %   %   % %   % % % %   %       %       %   % % % % % %   %     %   % %     %
% % %%% %%% %%%%%%%%%%%%%%% %%%%% % %%%%%%% %%%%%%% %%%%% %%% % %%%%% % %%% % % % % %%% %%%%% % %%% %
% % %     %     %     %         %       % % %         %   % % %     % % %       % %   % % % % % %   %
% %%%%% % %%%%% % %%%%%%% % % %%% %%%%%%% %%%%%%% % %%%%% % %%% % % %%%%%%% %%% % % %%% % % % %%%%% %
% % %   % %           %   % % %               % % %     % % %   % % % %       % % %   % % %   %   % %
%%% % %%% %%% % %%%%% %%% % %%% %%%%%%% %%% % % % %%% %%% % %%% %%%%% %%% % %%% % % % % % %%% % % % %
% % %   %   % % %   % %   %   % % %   % % % %     %   % % % %     %       % % % % % % %   %     %   %
% % %%%%% %%%%% % %%% % % % %%% % % % % % % % %%%%%%%%% %%% % % %%% %%%%%%%%% % % %%% % %%%%%%% % %%%
%     %   %   %     % % % % %       % % % % %       % % % % % %       %         %   % %   %   % %   %
%%% %%%%%%%%% %%%%%%% %%%%% % % %%% %%% % % %%%%%%%%% % % % %%%%%%%%%%% %%%%%%%%%%% % % %%% % % % % %
%   %           %             %   % %   %                   %       % % %       % %   % % % %   % % %
%%% %%%%% %%% %%%%%%% %%%%% %%%%% % %%% %%%%% %%% % %%% % %%% %%%%% % % %%%%%%% % %%% %%% %%%%%%% % %
% %   %   %           %     %   % % % %   %   %   %   % %         % %   %   %             %   %   % %
% % %%%%%%%%%%% %%% %%%%%%% % %%%%% % % %%% %%% % % %%%%%%%%%%%%%%%%%%%%% % % %%%%%%% %%% %%% % %%% %
%       %   % % % %   %   % %   %   %     % % % % %   %     %     %       % %     %   % %         % %
% %%%%%%% % % %%% % %%% %%% % % %%%%%%%%% % % % % % %%% %%% %%%%% %%%%% % %%%%%%% % %%% %%%%% %%% %%%
%     %   %       %   %       %   % %     %   % % %       %   %     %   %   %     % % %       % %   %
%%% %%% % % % %%%%%%%%%%%%%%% % %%% %%%%%%%%%%% % %%%%% %%%%% % %%%%% %%%%%%% %%%%% % %%%%% % % %%% %
%       % % % % % %       %   % %               % %   % % % % %   % % % %   %     % %   % % %   %   %
% %%% % %%% % % % %%%%% %%%%%%%%%%%%%%%%%%%%% %%%%% % %%% % % %%% % % % % % % %%% %%% %%% % %%% %%% %
%   % %   % % % % %   %       %   % % % % % %     % % %       % % %       %   % %   %     % %     % %
%%% % %%%%%%% % % %%% % % % %%% %%% % % % % % %%%%%%% %%% % %%% % % %%% % %%% % %%%%% % %%%%% %%%%% %
% % %   % %   %   %   % % %   %   %     %     %     %   % %   % %   %   % % %     %   % % %   %     %
% % % % % % % % %%%%% %%% %%%%%%% %%% % % %%%%%%% %%% %%%%%%% % % %%%%% % % %%%%%%%%%%% % %%%%% % % %
%   % % % % %   %         % %   % % % %   %     %     %       %     %   %   %     %   %   %     % % %
%%% %%%%% %%% % %%%%%%%%% % % % % % %%% %%%%%%% % %%%%%%%%% % %%%%%%% % %%% %%% %%%%% % % % % % % % %
%   %   % %   % % %       %   % % % % % % % % %     % % % % % %   % % %   %   %     % % %   % % % % %
%%% % %%% %%%%% % % %%% %%%%% %%% % % % % % % %%% %%% % % %%% % % % % % % %%% %%% %%% % %%%%% %%%%%%%
%         %         %       %       %       % % % %       % %   % % % % % % % %           %       % %
% %%% %%%%%%%%% %%% %%%%%%%%% %%% %%%%%%%%%%% % % % %%%%% % % % %%% % % %%% %%%%% %%%%% %%% %%%%%%% %
% % %   %   %   % %       %   %   %   %   % % %     %   %     %       % %       % % %   % % % %     %
% % %%%%% %%%%%%% %%% %%% %%% %%% %%% %%% % % %%%%%%%%% % % %%%%%%%%% %%%%%%%%% % % %%% % % % % % %%%
%   %       % %     % %   %     % %         %   % %   %   % % % % % % % %   %   % %       %   % % % %
%%% % % % %%% % %%%%%%%%% % % %%%%%%%%% %%%%%%% % % % %%%%%%% % % % % % %%% % %%%%%%% %%% % %%%%% % %
%     % %   %     % %       % % %   %   % %     %   %   %       %     % % %       %   %   %   %     %
% % %%%%%%%%% %%% % %%%%% %%% % % %%% %%% % % % %%%%%%% % %%% % %%% % % % %%%%% %%%%%%% %%% %%%%% %%%
% % %     %     %   %       %           %   % %       %   % % % %   % %                   %         %
%%% %%% %%% %%%%% %%% %%%%%%% %%%%%%%%%%%%% %%%%% %%% %%% % %%% % %%% %%%%% %%%%%%%%%%%%%%% % %%% %%%
%   %       % %   %   %       %     % %   %   % %   %     %   %   % %     %     % % %       %   %   %
% % %%%%%%% % %%%%% % %%% % % % %%%%% % % % %%% %%% %%%%% % % %%%%% %%% %%%%%%% % % %%%%%%% % % %%%%%
% %   %   %     % % % %   % % %         %         % % %     % % %     % % %         %     % % %     %
% %%%%% %%% %%% % %%%%% %%%%% %%% % % %%%%% % %%%%% % % %%%%%%% %%%%% % % %%%%%%%%%%% % % %%% %%%%%%%
%     %       %   %       %       % %   %   %     % % %     %     %   %       %   % % % %   %       %
%%% %%%%%%%%% % % %%% %%%%%%%%%%%%%%%%% %%% %%% %%% % % %%%%%%%%% % % % %%% %%% %%% % %%%%% %%%%%%%%%
%   %   %   % % % %     %     %     %     %   %   % %       %       %   % %     %     % %     % %   %
%%% % %%%%% % % %%%%% %%% %%%%% %%%%% %%%%% %%%%%%% % % % %%%%%%% % % % % % % %%% %%% % %%%%% % % %%%
%   %   %     %     % %   % % %   %   %         % % % % %   %   % % % %   % %   %   %   %     %   % %
% %%%%% % %%% %%%%% %%%%% % % %%% % % %%%%%%% % % % %%%%%%% % %%%%% % %%% % %%%%% %%% %%% % % % %%% %
%     %   %   %     %       % % %   % %     % %   % %   % % %     % %   % % % %   % %   % % % %   % %
% %%%%% % %%%%% % %%% %%% %%% % % %%%%% %%%%% %%% % % % % % % % %%%%% % % %%% % %%% %%%%%%% % %%% % %
% %     %     % %   % %     %   %     % % % % % % % % %     % %     % % %         % %     % %   %   %
% % %%% % %%% %%%%%%% %%%%%%% % % %%%%% % % % % %%%%% % %%% % % %%% %%% % %%%%% %%% % %%% %%% %%%%% %
% % % % % %     % % %     % % %         %   % % % % % %   %   % %     % % %   %     % %   %       % %
%%% % % %%% %%%%% % % % %%% % %%% %%%%% %%% %%% % % %%% %%% %%%%% %%%%%%%%% %%% %%%%%%%%% %%% %%% % %
%     % % %   %       %   %   %   %   %   %   %       %   %   %   %     %           %     %     %   %
%%%%% %%% %%% %%%%% % % %%%%%%%%% %%% %%%%% % %%% % % %%%%% %%% %%% %%% % %%%%%%%%% % % %%%%%%% %%% %
%   % %             % % %   %     %   % % % % %   % % % %     %   % %     % % % %   % %         %   %
%%% %%% %%% %%%%%%%%%%% % %%% % %%% %%% % %%% %%%%%%% % %%%%%%% % %%%%%%% % % % %%% % %%% %%% % % % %
%       % %   %     %   %     % %             % % %   %     %   % % % %       % % % % % %   % % % % %
%%%%%%% % % %%%%% % % %%%%%%%%% %%% % %%%%%%% % % % %%% % %%%%%%% % % % %%% % % % %%%%% %%% %%% %%% %
%   %   %   %     %   %   %   % %   % % %     %   %   % % % % %   % %     % %   %   %     %   % %   %
% % % %%%%% %%% %%%%% %%% %%% % % %%% % %%% %%%%% % %%% %%% % % % % %%% %%%%%%% % %%% % %%%%% %%% %%%
% %       %   %   %     %   %   % % % %               % %       %   % % %   %   % % % %   %   % %   %
%%% %%%%% % %%%%% %%% %%%%% %%%%%%% % %%%%%%%%%%%%% %%% %%% %%%%%%%%% %%% %%%%% % % % %%% %%%%% %%%%%
% % %     %   % %   %   %   % % % %     % %             %       % % %       %   % %     % %     %   %
% %%%%% % % % % %%%%%%%%%%% % % % %%%%%%% %%% %%% %%%%%%% % % %%% % %%% %%%%%%% % %%% %%%%%%% %%% %%%
% % %   % % %   %   %   %   %   %         %     %   % % % % %   % % %   % %       %           %   % %
% % %%%%%%%%%%% % % %%% % %%% %%%%% %%% %%% %%%%%%%%% % %%% %%%%% % % %%% %%%%%%% %%% %%% % %%% %%% %
%   % % % % %   % %   %     %   % %   %     % %   %                         %       % %   % %   %   %
% %%% % % % % % %%% %%%%%%% % %%% % % %%% %%% %%% % % %%%%%%% % % % % % % %%%%%%%%%%% %%%%%%%%% %%% %
%             %   % %   %       %   % % % % % % %   %   % %   % % % % % %     %           % %     % %
%%% % % %%% % %%% % % % %%%%% % %%%%% % %%% % % % %%% % % %%% %%%%%%%%%%%%% % %%%%% %%%%%%% % %%%%% %
% % % % % % % % %   % % %     % % % %         %     % % %   %   %   % %     %   % %     % %   %     %
% % % % % % % % %%% % %%% %%% %%% % % % %%%%% %%%%%%%%%%% %%%%% % %%% % %%% % %%% % %%%%% % % %%% % %
%   % % %   %   %         % % %     % % % %     % % % % % % % % % %       % % %       % %   %   % % %
%%%%% % % % %%%%% %%%%%%% % % %%%%% % % % %%% %%% % % % % % % % % % % % %%%%% % %%% %%% % %%% %%% % %
%   % % % %     % %     %   % %       % % %   % %           %   % % % % % %     %           %     % %
% %%% %%%%% %%% %%%%%%% %%% %%%%%%% %%%%% %%% % % % %%%%% %%%%% % % % %%% %%%%%%%%%%%%%%% % %%%%%%%%%
%     %   %   %   %     %     %     %     %     % % %       %   %   %           %       % %   %     %
% % %%%%% % %%%%% % %%% % %%% %%%%%%%%% %%% % % % %%% %%% %%% % % %%%%%%% %%%%%%%%% % %%% %%% % %%%%%
% % %       %     %   %   % % % % % %     % % %     %   %     % %     %     %     % %   %   %   %   %
% %%%%% % %%% % %%%%%%% %%% % % % % %%%%% % %%%%%%%%% % %%%%%%% %%% %%% %%% %%% % %%% %%% % % %%%%% %
%   % % %   % %   % %   %   % %   %     %   %       % % %   %   % % % %   % % % %   %     % % %   % %
% %%% % %%%%% %%%%% %%%%%%% % % %%% %%% % %%%%%%%%% %%% % % %%%%% %%% %%%%% % %%% %%%%% %%%%% % %%% %
%   %       %   %         % %   % % % %       % %     %   %     %   % %   % %   %           % %     %
% % %%%%% %%%%% %%%%%%%%% % % % % %%% % %%% %%% % % % %%%%% %%% % % % % % %%% %%%%% % % % %%% %%%%% %
% % % % % % %   % % % %       %           % % %   % % %   %   % % % % % %       %   % % % %   % %   %
%%%%% % % % % % % % % % %%% %%%%%%%%%%% %%%%% %%% %%% %%% % % %%%%% % %%% % % % % %%% %%%%%%% % %%% %
%     %   % % %   %   %   %   % %     %     % %   % %       %   %         % % %   %       %     %   %
%%%%% % %%% %%%%%%% %%% %%% %%% % %%%%%%% % % %%%%% % %%%%% %%%%%%% %%% % %%%%%%% % %%%%%%% %%%%%%% %
% % % %   %       %   %   %     %     %   % %     %   % % %     %   %   % %   %   %     % % % % % % %
% % % % %%%%% % % % %%% %%%%%%%%%%% %%%%%%% %%%%% %%% % % %%%%% %%%%% %%%%% % %%%%%%%%% % %%% % % % %
%         %   % %   %           % % %     %     %           % %     % %     % %         %   % % %   %
%%% % %%% % %%%%% % % % %%%%%%%%% % % % %%%%% %%%%% %%%%% %%% %%% % % %%% %%% %%% %%% % %%% % % % %%%
%.  %   % %     % %   %               %     % %     %     %       % % %     %     %   %             %
%%%%%%%%%%%%%%%%%%%%%%%%%%%%%%%%%%%%%%%%%%%%%%%%%%%%%%%%%%%%%%%%%%%%%%%%%%%%%%%%%%%%%%%%%%%%%%%%%%%%%