%%%%%%%%%%%%%%%%%%%%%%%%%%%%%%%%%%%%%%%%%%%%%%%%%%%%%%%%%%%%%%%%%%%%%%%%
%       % % %           %   %     %        % % %           %   %     % %
% %%%%%%% % %%% % %%% %%% %%%%%%% %  %%%%%%% % %%% % %%% %%% %%%%%%% % %
%       %       % %     %     % %          %       % %     %     % %   %
%%%%% %%%%% %%% % % % %%% %%%%% % %%%%%% %%%%% %%% % % % %%% %%%%% % %%%
%   % % % %   % % % %   % %   % %      % % % %   % % % %   % %   % %   %
% %%% % % % %%% %%%%% %%% % %%% %%%  %%% % % % %%% %%%%% %%% % %%% %%% %
%       %     %   %   %     % % %          %     %   %   %     % % %   %
%%% %%%%%%%%% %%%%%%% %%% %%% % % % %% %%%%%%%%% %%%%%%% %%% %%% % % % %
%             %       % %   %     %              %       % %   %     % %
% % %%%%% % %%% % % %%% % %%% %%% %  % %%%%% % %%% % % %%% % %%% %%% % %
% % %     % % % % %     %   % % % %  % %     % % % % %     %   % % % % %
% % % %%%%%%% % %%%%%%%%% %%% % %%%  % % %%%%%%% % %%%%%%%%% %%% % %%% %
% % % %     %   %     %     %   %    % % %     %   %     %     %   %   %
%%% %%% % %%%%% %%%%% %%% %%% %%%%% %% %%% % %%%%% %%%%% %%% %%% %%%%% %
%     % % %     % %     % %   % % %      % % %     % %     % %   % % % %
% % % % % %%% %%% %%% %%% % % % % %  % % % % %%% %%% %%% %%% % % % % % %
% % % % %                 % % %      % % % %                 % % %     %
%%% %%%%%%% % % %%%%% %%% % %%% %%%%%% %%%%%%% % % %%%%% %%% % %%% %%%%%
%       % % % %     %   %     % %          % % % %     %   %     % %   %
%%%%% % % %%%%%%%%% %%%%%%%%%%% % %%%%%% % % %%%%%%%%% %%%%%%%%%%% % %%%
%   % %           % %     %   % %      % %           % %     %   % %   %
% %%% %%%%% %%%%%%%%% %%%%% % % %%%  %%% %%%%% %%%%%%%%% %%%%% % % %%% %
% %   %      %        %     %        %   %      %        %     %       %
% % % %%%%% %%% % % % % %%%%%%%%%%%% % % %%%%% %%% % % % % %%%%%%%%%%%%%
% % %   %     % % % %       %   % %  % %   %     % % % %       %   % % %
% % %%% %%% % % % %%%%%%%%% %%% % %  % %%% %%% % % % %%%%%%%%% %%% % % %
% %   % %   % % %   % %   % % %      %   % %   % % %   % %   % % %     %
% %%% %%% %%%%% %%% % % %%%%% % %%%% %%% %%% %%%%% %%% % % %%%%% % %%%%%
% % % % % % % %     % %   % %   % %  % % % % % % %     % %   % %   % % %
% % %%% % % % % %%%%%%%%% % % % % %  % %%% % % % % %%%%%%%%% % % % % % %
%   %   %   %                 %        %   %   %                 %     %
% % % % %%% %%% %%%%%%% %%% %%% %%%  % % % %%% %%% %%%%%%% %%% %%% %%% %
%P                %       %   % %    % % %       %   %       %   % %  .%
%%%%%%%%%%%%%%%%%%%%%%%%%%%%%%%%%%%%%%%%%%%%%%%%%%%%%%%%%%%%%%%%%%%%%%%%