%%%%%%%%%%%%%%%%%%%%%%%%%%%%%%%%%%%%%%%%%
%P                  %     %       %     %
% % %%%%%%%%%%%%%%% %%% %%% %%%%%%% % %%%
% %   %     % %   % %       % %     %   %
%%% %%%%% %%% % % %%%%% %%% % % %%% %%% %
%     %       % % % %     % % % % % %   %
% %%% % %%% % %%% % %%% %%%%% %%% % %%%%%
% %       % %   % % %     % %         % %
%%%%%%%%% %%% %%% % % %%%%% % % %%%%% % %
%   %       %   %   %   %     %   %     %
% %%%%%%% % %%% %%% %%% %%% % %%% % % % %
%   %   % % %   %     % % % %   % % % % %
% %%%%% %%%%%%% %%% % % % %%% %%% % %%% %
%     % %   % % %   % %   %   % % % %   %
%%% % % % %%% % %%% %%%%% % % % %%%%% %%%
% % %     % %   %       % % %       %   %
% %%%%% % % %%% % % % % % %%%%% %%%%% % %
%   %   %     % % % % %     %   % % % % %
%%% %%%%%%% % % % %%% % %%% % % % % %%%%%
%     %   % %     %   % %     %     % % %
%%%%% % %%% %%% %%%%%%%%% % %%%%% % % % %
%   %   %     %         % %   % % % % % %
% %%%%% % % %%%%% %%%%% %%%%% % % %%% % %
%   % % % %   % % %     %   % %       % %
%%% % % %%%%% % %%%%%%% %%% % %%% %%% % %
% %       %   %   % % %   % % %     %   %
% % %%%%%%% % %%% % % % % % %%%%%%% %%%%%
%   %   %   % %       % % %   %     %   %
% % % %%%%%%%%% %%%%% % % %%% % %%% % %%%
% % %     %     % %   % % % %   %       %
% %%% %%% % %%% % %%% %%%%% %%% %%%%%%% %
%   % %   %   % %   % %     % %     % % %
%%% % % %%% %%% %%% %%% %%% % % %%% % % %
%   % %       %     % % % %       % %   %
%%% % % % %%%%%%%%% % %%% % %%% %%%%% % %
%   % % %     % % % %         % %   % % %
%%% %%% %%%%% % % % %%%%%%%%%%% % %%%%% %
%         % %     %       % %       % % %
%%% % %%%%% %%%%% %%%%% %%% % %%%%%%% % %
%.  %   %         %               %    %
%%%%%%%%%%%%%%%%%%%%%%%%%%%%%%%%%%%%%%%%% 