%%%%%%%%%%%%%%%%%%%%%%%%%%%%%%%%%%%%%%%%%%%%%%%%%%%%%%%%%%%%%%%%%%%%%%%%%%%%%%%%%%%%%%%%%%%%%%%%%%%%%
% % % %   %       % %     % %       %     % % %       %   %       % % % %     %     %       % %    P%
% % % % % %%%%%%% % %%% %%% % %%%%% %%% % % % % %%% %%% %%%%% % % % % % %%% %%% %%% %%%%% %%% % % %%%
%       %       %   %     %   %         % % %   %   % %   % % % % %       %     % % %     % %   % % %
% %%%%%%%%%%% %%% %%%%% %%%%%%%%% %%% %%%%% % %%% % % % % % % % % %%%%% % % %%%%% % % % % % % %%%%% %
%   % %   %     %       %       % %       %     % %     %     % % % %   % % % %     % % %           %
%%%%% %%% %%% %%% % %%%%%%% %%%%%%% %%%%%%% %%% %%%%% %%%%%%%%%%% % % %%%%% % %%%%% % % % %%%%% % % %
%       % % %   % %   %     % %         % % % %     % % %   %       %   %   %   % % % % % %     % % %
% % %%% % % % % %%%%% % % % % %%% % %%%%% % % %%% % % % % %%%%% %%% %%% %%%%% %%% % % % % %%%%% %%%%%
% % %       % % % %     % %   %   %   % %   %     % % %   %       %   % %         % % % % %   % %   %
% % %%% %%% %%% % %%% %%%%%%% % %%%%%%% %%%%% %%% % %%% %%%%%%% %%%%%%% %%% % %%% % %%% %%% % % % % %
% % %   %             %   % %         %     %   % %   %     %     % % % % % %   % % % % %   %     % %
%%%%%%% % %%%%%%%%%%% %%% % % %%% %%%%%%% %%%%% %%%%%%% %%%%% % %%% % % % %%%%% %%% % %%%%% % %%% %%%
% %     %     % %     %     % %       %     %       % %       % % %             %   %   % % %   %   %
% % % %%%%% % % %%%%%%% %%%%%%%%%%% % %%% % % % %%% % %%% % %%% % % %%%%%%% %%%%%%% % % % %%% % %%%%%
%   % %     %     % %       %   % % % % % %   % %       % %   % % %     % % % %       %     % % %   %
%%%%%%%%%%%%% %%%%% %%%%% %%% %%% %%% % % %%%%%%%%%%%%%%%%%%% %%% % % %%% %%% % % % %%% %%% % %%%%% %
%   %     %     %   %       %       % %     % % %     %       %   % % % % % %   % % %   % %   %     %
% % %%% %%%%%%% %%% % %%% %%%%% % %%% % %%%%% % %%%%% %%% % % % %%% %%% % % % % % %%%%%%% %%% % %%% %
% %   % % %   % %       %   %   %     %     %     % % %   % % %           %   % %       % %       % %
%%% %%% % %%% % %%% %%%%%%%%%%%%%%%%% % %%%%%%% %%% % %%%%%%%%%%%%% % %%%%%%%%% %%%%% % % % %%%%% %%%
%   %   %   % %   %   % % %   %   % % %   %     %       % %     %   % % %       %   % % %     %   % %
% % % %%%%% % %%% % %%% % % % % %%% %%% %%%%%%% %%% % % % % %%%%% % % % % %%%%% %%% % %%% %%% %%%%% %
% %   %           %       % %   %     %     %   % % % %   %     % % %   %   %     % % % %   % %   % %
% % %%%%%%%%% %%% % %%%%% %%% %%% %%%%% %%% %%% % % % % % %%% %%%%% %%% % % % %%%%% %%% % %%%%%%% % %
% %         % % % % % % % %         %   %   % %   % % % % %   % %     % % % %     % % % %       % % %
% % %%%%%%% % % % % % % % % %%%%% %%% %%%%%%% % %%%%%%%%% %%% % % % %%% % % %%% %%% % % % %%%%% % % %
% %   %     % %     %         %       % %   %       % % %     %   % % %   %   % %         %   %     %
%%%%% %%%%% % % %%%%%%%%%%%%% %%%%%%% % %%% %%% %%%%% % % %%%%% % %%% %%% % %%%%% %%%%%%% % %%% %%% %
%   % %       % % %     % % % % % %   %               % % %   % %     % % %   % %   %     % %   %   %
%%% % % %%% %%%%% %%% % % % %%% % % %%% %%%%%%%%% %%% % % % %%%%% %%%%% % %%%%% %%% % %%%%% % %%% %%%
% % % % %       %     % % % % % % %           % % % %       % % % %       % %       %   %   %   %   %
% % %%%%%%% %%%%%%% % %%% % % % % % %%% %%%%% % %%% %%% %%% % % %%%%%%% %%% %%% % % %%%%% % %%%%%%%%%
%   %   % %         %   %     %     %     %       % %     % %     % % % % %   % % %       %   %     %
%%% %%% % % % % % %%%%% %%% %%% %%%%% % % %%%%%%%%% %%% %%%%% %%% % % % % % %%%%%%% %%%%%%%%% % % %%%
%           % % % % %   %   %       % % % %     % %         % %   %           % %   %   % %   % %   %
% %%% %%% %%%%%%% % % %%% %%% %%%%%%%%% %%%%% %%% %%%%% %%% %%% %%%%% %%%%%%% % % %%% %%% % %%%%% % %
% %   %   %   % %   %     %       %   %   %   % %     % %             %   %     % %   %       % % % %
% %%%%% % %%% % %%% %%%%% %%%%%%% % %%%%% % %%% % % %%%%% % %%%%% % %%%%% %%% %%%%% %%% %%% % % % % %
%     % %         %   % % % % % %   %   %     % % % %     % %     % % % %   % %     %     % % % % % %
% %%% %%%%%%%%%%%%%%%%% % % % % % % %%% % % % % %%% %%% %%% % %%%%% % % %%% % %%% %%%%% % % %%% % %%%
%   %     %   %     % %       %   % %   % % %         % % % % %     %     %   %       % % % % %   % %
% % %%% %%% %%% % %%% %%% %%%%%%% %%% % % %%% % %%%%%%%%% % % % %%% % %%%%%%%%% % %%% %%%%% % % % % %
% %   %     %   %     %         %   % % %   % % %   % %   % % %   % % %   %     % %           % %   %
% % %%%%%%%%%%% %%% % %%%%% %%%%%%%%% %%%%%%% % % %%% % % % % % %%%%% % %%%%% % %%%%% %%%%%%%%% % %%%
% %   % % % %   %   % %   % % % %         %   %   % %   %   % %           % % %     % %   %     %   %
% %%%%% % % %%%%% %%% %%% %%% % % % %%%%%%% % % %%% %%%%% % %%% % %%% %%%%% % %%% %%%%%%% %%% % %%% %
%   %   %     % % %         %   % %       % % %   %   % % %   % %   %   % %     %     % % %   %   % %
% %%% %%% %%%%% %%%%%%% %%%%%%% %%% %%% %%%%% %%%%% %%% %%% %%%%% % % %%% %%%%% %%%%%%% % %%% % %%%%%
% % %               %       % %   % %   % %     % % %     % % %   % %         %     % %       %   % %
% % %%%%% % %%% % %%%%%%% % % % %%%%% %%% % %%% % % %%% % % % %%% %%% % % % % % % %%% %%% %%% %%% % %
%     %   % % % %     % % %         %     %   %   %     % % %   % % % % % % % % %   %     %   %   % %
%%%%% % % %%% % %%% %%% %%% % %%% % % %%%%%%%%%%%%% % %%% % % %%%%% % %%% %%% %%%%% % % %%%%% %%% % %
% %     %   %   %   %       %   % %   %     %   %   %   %         %   %     % %     % % %       % % %
% % %%% %%%%% % % %%% %%%%% % % %%% %%% % %%% %%% %%% %%%%%%%%%%%%%%% %%% % %%%%%%%%%%% %%%%%%%%% % %
%   %   %     % % % % %     % %   %     % %     %   %     %     %       % % %       % % % % % %     %
% %%%%% %%%%% %%%%% %%%%% %%% % %%% % %%%%% %%% % % %%%%% %%% % % % % % % %%% %%% %%% %%% % % %%%%% %
%     % % % %   %   %   % % % % %   % %   % % % % %   %     % % % % % % %       %           % % % % %
% %%%%%%% % %%% % % % %%%%% % %%% %%% % % % % %%%%% %%%%%%%%%%% %%% %%% % %%% % %%% % %%%%%%% % % % %
%     % %   %     % %     %     %   % % %       %   %             % %   %   % %   % % %   % %       %
% %%% % % %%%%%%% % % % %%%%% %%% %%%%% %%% %%% %%% % %%%%% %%%%%%%%%%% %%% %%%%%%%%% %%% % %%% %%% %
%   % %   %       % % % %   %   %   % % %     %   % %   %   %         %   %         %       %     % %
%%% %%%%% % %%% %%% % %%% % %%%%% % % %%%%%%% %%% % % % %%% %%% %%%%% % %%% %%% %%%%%%% %%%%% % %%%%%
%     %     %   % %   %   %       %   %   %   %   %   % %       % %   % %   %   % %         % % % % %
% %%%%%%% %%%%%%% % %%%%% % % %%%%% %%% %%% % %%% %%%%%%% %%%%% % % % %%% % %%%%% % % %%%%% %%% % % %
% %         %   % % %     % % % % %     %   %   % % %     % % % %   % %   %   % % % %   % % %     % %
%%% %%%%%%%%%%% % % %%% % %%%%% % %%% %%% %%%%% %%% %%% % % % %%%%%%%%%%%%%%% % % %%%%%%% % %%%%% % %
% %     % %     %     % %   % %   % %   % %   %       % %   %               %         %   % %     % %
% % %%%%% % % %%%%% % % %%%%% %%% % %%%%% % % %%% % %%%%%%% % % %%% %%% %%% % % %%%%% % % % %%%%% % %
% %   % %   % % %   % %     % % %         % % %   % %     %   %   % %     % % %     % % % %       % %
% %%% % %%% %%% % %%% % %%%%% % %%%%% %%% % %%%%%%% % %%% % %%% %%%%%%%%%%%%% % %%% %%% % %%% %%%%% %
% %   % % % % %   %   %   %         % %         % % % %       % % %   % % %   %   % % % %           %
% %%% % % % % %%%%%%% % % %%%%%%%%% %%%%% % %%% % % % % %%%%%%%%% %%% % % % % %%%%%%% %%%%% % %%% %%%
% %       % %     %   % %   %     % %     %   % %     % %     % %   %   %   %       %       %   %   %
% %%% %%%%% % %%% %%%%%%% %%%%% % % % %%%%% % %%%%%%% % % % % % % % % % %%% % %%% %%% % %%% % %%%%%%%
%             % %   % %     % % % % % %     % % %     %   % %     % % %     % % %   % %   % % % %   %
% %%%%%%%%% %%% % % % %%% % % %%% % %%%%% % %%% %%%%% % %%%%%%%%% %%% % %%%%% % %%% % %%%%%%%%% %%% %
%     % %     %   %   %   %   %           %       % % % %   % %   %   % %   %   % % %     % %       %
% %%%%% % %%%%%%% %%% % %%%%% %%% %%%%% % %%%%%%%%% % % %%% % % %%%%%%%%%%% % % % %%% %%% % %%%%% %%%
%   %     % % %     % %     %   %     % %         %   % %         %     % %   % %       % %   %   % %
% %%% % %%% % %%% %%% %%% %%%%%%% %%% % %%%%%%% %%%%%%% %%% %%%%%%%%% % % % %%%%%%%%% % %%%%% % %%% %
%   % % % %   %   %       %       %   % % %       %       % %     %   % % % %         %   % % %     %
%%%%%%% % %%% % %%% % %%%%%%% %%% %%% %%% %%%%% %%% %%% %%%%% %%%%% %%%%% % %%% % %%% %%%%% % %%%%% %
%         %     %   %   %   %   %   % %         %   %   %   %   % %   % %     % % %   %     %       %
% %%% % %%%%%%%%% % %%%%%%% %%%%% % % % % % % %%%%%%%%% %%% % %%% % %%% %%%%%%% %%% % % % %%%%% % % %
%   % % %     %   %       %   % % % % % % % %   % %     %     % % %   % % % % % % % %   %       % % %
%%%%% % %%%%% %%%%% %%% %%% %%% % % %%% % %%% %%% %%%%% %%%%% % % % % % % % % %%% %%%%% %%%%%%% % %%%
% %   % % %       %   % % %     % %   % %   % %       % %         % %   %     %   %         % % %   %
% % %%%%% %%%%% %%% %%% % % %%%%% %%%%%%% %%%%%%% %%%%%%%%%%% %%% %%% %%% %%% %%% %%%%% %%%%% %%%%%%%
%                 % % %   % %   % % %   %         %   %   %     % %         % %   %   %   %         %
%%%%% % % %%% %%%%% % % %%% %%% %%% % % %%% % % %%% %%% %%%%% % %%%%%%% %%% %%%%% % % % %%%%% %%%%%%%
%   % % % %   %       % % %   % %   % % % % % %           %   % %         % % % %   % %   % % %     %
% %%%%%%%%%%%%%%%%%%% %%% % %%% % %%% % % %%%%%%%%% %%% %%%%% % %%% % % % % % % % %%% %%%%% % % % %%%
%   %       %         %         %     % %   %     %   % %     % %   % % % %   %   %   %     % % %   %
% %%% % %%% %%%%% %%%%% %%%%% %%% % %%%%%%% %%%%% % %%%%% %%% % %%% %%%%% %%%%%%%%% % %%% %%% % %%% %
% %   % %         % %   %         %   %   %   %     % %     % %         % %       % %       %     % %
% % %%%%% % % %%% % %%% %%%%%%%%%%% % %%% %%% %%% % % % %%% %%% %%%%%%%%% % % % %%% % %%%%% % %%% %%%
%     % % % %   % %   %   % %   % % %     % % %   % % %   % %   %   %       % %     %     %   % %   %
% %%% % %%%%% %%%%%%% %%% % % %%% %%% %%% % % %%% %%% % % %%% %%%%% % %%%%% %%% %%%%%%% %%%%% % %%% %
%.%       %     %         %             %               %   %     %   %       %     %     %       % %
%%%%%%%%%%%%%%%%%%%%%%%%%%%%%%%%%%%%%%%%%%%%%%%%%%%%%%%%%%%%%%%%%%%%%%%%%%%%%%%%%%%%%%%%%%%%%%%%%%%%% 