%%%%%%%%%%%%%%%%%%%%%
% %   %           % %
% % % %%% %%% % % % %
%   %   % % % % %   %
% %%% % % % % %%% %%%
%   % %   %     %   %
%%%%% %%% %%%%% %%%%%
%   % % % % % % %   %
% %%% % %%% % % % %%%
%   % % % % % %   % %
% %%% % % % % %%%%% %
%   %         %     %
%%% %%%%% % %%% % % %
% % %     % % % % % %
% % % %%%%% % % %%% %
%   % % % %   % %   %
% %%% % % %%% % %%% %
%   % %     %     % %
% %%% % %%%%%%% % %%%
%.          %   %  P%
%%%%%%%%%%%%%%%%%%%%% 