%%%%%%%%%%%%%%%%%%%%%%%%%%%%%%%%%%%%%%%%%%%%%%%%%%%
%P    %       %             % %           % % %   %
%%% %%%%%%% %%% %%%%%%% % % % % %%% %%% % % % % % %
%   % %   % % % % %     % % % % %   %   %     % % %
% %%% % % % % % % %%%%% % % % %%% % % %%% %%%%%%% %
% %     % %       %     % %   %   % %   % %   %   %
% % %%%%% %%%%% % % %%% %%%%%%%%%%% %%%%%%% % % %%%
%   %           % % % %       %       % %   % %   %
%%%%%%% %%% % %%% %%% %%%%% %%% % %%% % %%%%% % %%%
% %     %   % %           % %   % % % %   %       %
% % % % %%%%% % %%%%%%%%%%%%%%%%%%% % % %%% % %%%%%
%   % %     % % % % %       %     %     % % % %   %
%%%%%%% %%%%% % % % % %%% %%% %%% %%% %%% % %%%%% %
%       %   % %   % %   % %   %   %   %     % %   %
% % %%% % %%%%% % % % %%% %%%%% % %%% % %%% % %%% %
% % %     % %   %   % %       % % %     %   %   % %
%%%%% %%%%% %%%%%%%%%%% % %%%%%%% %%% %%% %%% %%% %
%               %       %   % %     % %     %     %
% %%% %%%%%%%%%%% %%%%%%%%% % %%%%% % % % % % % % %
%   %   % %   % % % % % % %   %     % % % %   % % %
%%%%% %%% % %%% % % % % % %%%%%%% % %%%%%%% %%%%% %
%       %           % %     %     % % % %       % %
% %%%%%%%%%%%%%%%%% % % %%%%%%%%% %%% % % % %%%%%%%
%   % % %                 % %     % %     % %   % %
% % % % %%% %%%%% % %%%%% % %%%%% % %%%%% %%% %%% %
% %   % % %     % %   % %     %     %           % %
%%% %%% % %%%%% %%%%%%% % % %%%%%%% % % %%%%%%% % %
% % %   %   % % %         % %   % % % % %   %   % %
% % % %%% %%% %%%%% %%% % %%%%% % % % % %%% %%% % %
%           %     % %   % % % % % %   %     % % % %
%%%%%%% % %%% % %%%%% %%%%% % % % % %%%%%%% % %%% %
%     % %     %   %       %       %   %     %     %
% %%% % % %%%%%%%%%%% % %%% %%% % % %%% %%%%% %%%%%
% %   % %   %     % % %     %   % %   %         % %
% % % % %%% % %%%%% % % %%% %%% % %%%%%%%%% % %%% %
% % %   % %     %     % %   %   %       % % %     %
% %%%%% % %%%%% %%%%%%% %%%%%%% %%%%% %%% % % %%%%%
%   %       % %     % % %     %   % % %     %     %
% %%%%% %%%%% % %%%%% % %%%%% % %%% %%% %%%%% %%%%%
%   % %   %   %   %     %       % %     %         %
%%% % %%% % % %%% % %%%%% %%% %%% % % % % %%% %%% %
%     %     %   % %     % % %   % % % % % %     % %
% %%%%%%%%% %%%%%%% % %%%%% %%% % %%%%%%%%%%% % % %
%     % %           % % %     % %     %     % % % %
%%%%% % % % %%% %%% % % % %%% %%% % %%%%% % % % %%%
%     % % %   % %   %     %     % % %     %   %   %
%%% % % % %%% %%% % %%%%%%%%% % % %%% %%%%% %%% %%%
%   %   % %   %   %   % %     % %   %   % % % %   %
% %%%%% %%% %%%%% % %%% % %%% %%%%% % % % % % % % %
%.    % %   %     % %     %           % %     % % %
%%%%%%%%%%%%%%%%%%%%%%%%%%%%%%%%%%%%%%%%%%%%%%%%%%% 