%%%%%%%%%%%
%P  % %   %
% %%% % % %
%       % %
% %%% % %%%
%   % %   %
%%% % %%% %
% % % % % %
% % % % % %
%.  % %   %
%%%%%%%%%%% 