%%%%%%%%%%%%%%%%%%%%%%%%%%%%%%%
%     % %   %     % %        P%
% %%% % % % %%%%% % % % % % %%%
% %   %   %       % % % % % % %
% % %%% %%% %%%%%%% %%% %%%%% %
% %     %         %           %
%%% %%% %%%%%%% %%%%%%%%% % %%%
% % %     %     %     %   %   %
% %%%%% %%%%%%%%%%% %%% %%% %%%
% %     %           %   % %   %
% % %%% %%% %%%%%%% % %%% %%%%%
%     %     %   %   %   %     %
% %%%%% %%%%% % % %%%%% %%% % %
%   % %       % % %   %     % %
% %%% % %%%%% % %%%%% % %%% %%%
%   %   % % % %     % % % %   %
%%% %%% % % %%%%% %%% %%% % % %
%   % % % % %   % %   %   % % %
%%% % %%% % % % % %%% % %%% %%%
%             % %   % % %     %
% %%%%%%% %%%%%%% %%% % % % % %
% %         % %           % % %
% % %%% % %%% %%%%% %%% %%% %%%
% % %   %     %     %     % % %
%%%%% %%%%%%% %%% %%%%%%%%%%% %
%   % %     % %   %         % %
%%% % % % %%%%%%% %%%%% %%% % %
% % % % % %         % %   % % %
% % % %%% %%% % % % % % %%% % %
%.        %   % % %     %     %
%%%%%%%%%%%%%%%%%%%%%%%%%%%%%%%