%%%%%%%%%%%%%%%%%%%%%%%%%%%%%%%%%%%%%%%%%%%%%%%%%%%%%%%%%%%%%
% %                 % %     % %   %         % %   %   %     %
% %%% %%%%% %%% % %%% %%%%% % %%% % %%% % %%% %%% %%% %%%%% %
%         % % % %     % %     %   %   % %     % %   %       %
%%% %%%%% %%% % %%% % % %%% % %%% %%%%% %%%%%%% % % %%%%% %%%
%     %   %   %   % %   %   %   % % %       % %   %     %   %
% %%%%% %%% %%%%%%%%%%%%%%%%% % % % % %%%%% % %%% %%%%% % %%%
%   %   %   %   %     % %     % %       %   %     %       % %
%%%%% %%%%% %%% %%% %%% % % %%%%%%%%%%% %%%%% % %%% %%%%%%% %
%             % %   %     %     %   %     %   %   % %       %
%%%%% % % %%%%% % %%% %%% %%%%%%% % %%%%% % %%%%%%%%%%%%% %%%
%     % %   %       % % %   % % % % %   % % % %     %     % %
%%% %%%%%%% % %%% %%% % %%%%% % % %%% % % % % % % %%%%%%% % %
%   %   %     %             %       % %         %   % %     %
% %%% %%% %%%%%%% %%% % %%%%%%% % %%%%%%% %%% %%% %%% %%% %%%
%   % % %   %   % %   % %   % % %     % % % %   % % %       %
% % % % %%% %%% %%%%%%% % %%% % % %%%%% % % % %%%%% %%% %%% %
% % %       %               % % %   %     %       % %     % %
% % % %%% % % % %%%%%%%%%%% % % %%%%% % %%%%%%%%% % %%%%% %%%
% % % %   % % % %             %     % % % % %     %       % %
%%% %%%%%%% %%%%% %%%%%%%%%%% % % %%% %%% % %%% % %%%%% % % %
% % % % %   %     %       %     %   %   %   %   % %     %   %
% % % % %%%%% %%%%% %%% % %%%%% %%%%%%% %%% %%%%%%% %%%%%%% %
%   %   % %     %     % %       %   %       % % % %     %   %
% %%% % % %%% %%% %%%%%%%%%%% %%%%% %%% % %%% % % % % % % %%%
%   % %   %   %         %       % % % % %   % % %   % % %   %
%%% % % %%%%%%%%%%%%% % % % %%%%% % % %%% %%% % %%% %%% % %%%
% %   %         %     % % %     % %   %   %       % % % %   %
% %%% %%%%%%%%% %%%%% %%%%% %%%%% % %%% %%%%% %%% % % % %%% %
%   % % %       %       %         % %         %   %   % % % %
% % %%% %%%%%%%%%%%%% %%%%%%%%% %%% %%% %%% % %%%%%%%%% % % %
% %       % % %       % %         %   %   % %     %       % %
%%%%% %%% % % %%%%% %%% %%% %%%%% % % % % % %%%%%%% %%%%%%% %
% %   %   %       % %   %     %   % % % % %     %   %   %   %
% %%% % % % %%%%% %%%%% % % % %%%%%%% %%% %%%%% % % %%% %%%%%
%     % % % %   %   %   % % % % %   % % %     %   %   %     %
%%%%% %%% %%% % % %%% % % %%%%% %%% % % %%% %%% % %%% % %%% %
%       % %   % %     %     %           %   % % % % %   % % %
%%% %%%%% %%%%% %%%%%%% %%% %%% %%%%% %%%%% % %%%%% %%% % %%%
% % %   %             % %     %   %           % %     %     %
% % % %%%%% %%% %%%%% %%% %%% %%%%% % % %%%%%%% %%% % %%% %%%
%   % %     %       % %   %   %     % % %         % % %     %
% %%% %%%%% %%%%%%%%%%% % %%% %%%%% %%% %%%%%%%%% % %%% %%%%%
% %   % %           %   %   %         % %   %         % % % %
% %%% % %%% %%% %%%%%%% %%% %%% %%% % %%% %%%%% % %%% %%% % %
%   % % %     %   % %     % % % %   %   %     % % %   % %   %
% %%% % %%% % %%%%% %%% %%%%% %%%%% % %%% % %%% % % % % % %%%
% %     %   %           %   % %   % % %   % %   % % %       %
%%% %%% %%%%% %%%%%%%%% %%% % % %%% %%% %%% % % %%%%% %%%%% %
%     % %       % %   %     % %   %   %   %   % %       %   %
% % %%%%%%% %%% % %%% %%% %%% %%% %%% %%% %%% %%% %%%%% %%% %
% %           % %   %     %   %   % %     %     % %   % %   %
% %%%%%%% %%%%% %%% % % %%%%% %%% % % %%% % %%%%%%%%% %%%%% %
% % % %   %     %     % %   %       %   % % %     %       % %
%%% % % % % %%%%%%% % %%% % % %%% % % % %%% % % %%%%%%% % % %
%   %   % % % % % % %   % %   % % % % %   % % % % %   % % % %
%%% % % % % % % % % % %%% %%%%% %%% %%%%% %%%%% % % %%% %%% %
%     % % % %   %   %       %     % %   %   %             % %
% % %%% %%% % %%%%% %%%%% %%% % % % %%% % % %%% % %%% %%%%% %
%.% %     %       % %     %   % %   %     %     % %       %P%
%%%%%%%%%%%%%%%%%%%%%%%%%%%%%%%%%%%%%%%%%%%%%%%%%%%%%%%%%%%%% 