%%%%%%%%%%%%%%%%%%%%%%%%%%%%%%%%%%%%%%%%%%%%%%%%%%%%%%%%%%%%%%%%%%%%%%%%%%%%%%%%%
%P%           %       %   % %     % % % %         %     %     %     %     %     %
% %%% %%%%% % % % % %%% % % % %%% % % % % %%%%% %%% %%% %%%%% %%%%% % %%%%% % % %
%   % %     % % % %     % %     %           %     % %           %       %   % % %
%%% %%%%%%% %%%%% %%%%%%% % %%% %%%%%%%%%%%%%%% %%% %%% %%%%%%% % %%%%%%% % %%% %
%     % %   %           % %   % %   %   % % % %     %     %   % %     % % % %   %
% % % % % %%% %%%%%%%%% % %%% %%% %%%%% % % % % %%%%% %%%%% % % %%% %%% %%% % % %
% % %   %       %       %   % %     %   %   %   %         % % %       % %   % % %
%%% % %%% %%%%%%%%% %%%%% %%%%% % % % %%% %%%%% %%%%% %%% % %%%%%%% %%% % %%% %%%
%   %           % % %     %   % % %         %   %   % % %     %     % %   %   % %
% %%%%%%% %%%%% % %%% %%% % %%%%%%%%%%%%% % %%% %%% %%% %%%%%%%%% %%% % %%% % % %
%   %       %     %     %   %   %       % %   %           % %   %   %   % % %   %
% % %%%%%%%%% %%% %%%%%%%%% %%% %%% %%% %%%%% %%% %%% % %%% % %%% %%%%% % %%%%%%%
% % %   %       %   %   % % %   % % %               % % %   % %   % %   %       %
% % % % % %%% % % %%% % % %%% %%% % %%%%%%% %%%%%%% %%% % %%% % %%% % %%%%% %%% %
% %   % % %   % %   % % % %               % %   %     % %   %   % % %   %     % %
% %%%%% % %%%%%%% %%%%% % % %%%%% %%%%% %%% % %%%%% % %%%%% %%% % % % %%% %%% % %
%   %   %   %         %   % %   % %     % %   %   % %   %     %           % % % %
% %%%%% % % %%% %%% %%%%% % %%% % %%% %%% %%%%%%% % % % % %%%%%%%%%%%%% %%% %%%%%
% %     % %   % % % %   %     %   %         % %   % % %               %         %
% %%%%%%%%%%%%% % %%% %%%%% %%%%%%% % %%% % % % %%%%%%% %%%%% % %%%%%%% %%%%%%% %
% %     %             % %   %       % %   %     %       % %   %   % % % %   %   %
%%%%% %%% %%%%%%%%%%% % %%%%% %%%%%%%%%%% %%%%%%%%%%% %%% % %%%%%%% % %%%%% % % %
% %       % % %     % %     % % % %   %             % %   % % %     % %   %   % %
% % %%% % % % % %%% % % % %%%%% % %%% % % %%% % %%%%% % % %%% % %%%%% %%% %%%%%%%
% %   % %   %   % %     % %       % %   % % % % % %     % %   %     % %     %   %
% % %%%%%%%%% %%% %%% % %%% % % % % % %%%%% %%%%% %%%%% % %%% %%% % % %%% %%%%% %
%     %     %   % %   % % % % % %     %   % % %       % %   %   % %     % %     %
% %%%%% %%% %%% % %%% %%% % %%%%%%% %%%%% % % %%% %%% %%% %%%%% % %%% %%% % %%%%%
% % %     %         %       % %   %         %       %     %     % % % % %   %   %
% % %%% % % %%%%%%% % %%%%%%% % %%% %%%%%%%%% % % %%% %%% % %%%%%%% % % %%% %%% %
% %     % % % %   % %   %         % %   %   % % %   % %   % % % %         %     %
%%% %%% %%%%% %%% %%%%% % %%%%%%%%% %%% % %%%%%%% %%% %%%%% % % % %%%%% % % %%% %
%     % % %     %   % % % %   %             %       % % %           % % %   %   %
% %%%%%%% %%%%% %%% % %%% % % %%%%%%%%% % %%%%% %%% %%% %%%%%%% %%%%% %%%%% %%% %
%         %       %         % %     % % %   % % %     %     %   %       %   % % %
% %%%%%%% %%% % %%% % % % % %%% %%%%% % %%% % % %%% %%%%% %%% % % %%% % %%% % %%%
%     % % % % % % % % % % %               % % %   %   % %     %   %   % %   %   %
% %%%%% %%% % % % % %%%%%%% % %%%%% %%%%%%% % % %%%%%%% % % %%% %%%%%%%%%%%%%%% %
%     % %   % % % %     %   %   %       %     % %     % % %   % %     %         %
% %%%%% % %%% % % %%% %%%%% %%%%% %%% %%% %%%%% %%%%% % %%%%%%% % %%%%%%% % %%%%%
%     %       %     %     % % %   %   %   % %     %     %           % %   %     %
% % % %%%%%%% %%% %%% % %%%%% %%%%% %%% %%% % %%% % %%% % %%%%%%%%%%% % %%%%%%% %
% % % %     % % %   % % %       %   % % %     % %   %   %   %               % % %
% %%% % %%% %%% % % %%%%% %%%%% % %%% % %%% %%% %%% % %%% % %%%%% %%%%%%%%%%% % %
% %   % %   %     % % % % %   % %   %   % %   % %   % %   % %         % %   %   %
% %%%%% %%% %%% % %%% % % %%% % %%%%%%% % % % % % %%%%% % % % % %%%%%%% % % % %%%
%     %   % % % %     %     % %       % %   % %   % %   % %   %   % % %   % %   %
% %%%%% %%%%% % %%% %%%%% % % % % %%%%% %%% %%% %%% % %%%%% %%%%%%% % % %%% %%%%%
%   %   % % %   %     % % %   % % %   % %   % % % % %   %     %   % %     % % % %
% % %%% % % % %%%%% %%% %%% %%% % %%% %%%%% % %%% % %%% %%% %%% % % %%%%%%% % % %
% %   %     % %   %     % % %   % % %     %     %   % % % %     % %       %   % %
%%%%%%% % % % % %%%%%%% % %%%%%%% % %%% % % %%%%% % % %%% %%%%%%% % % %%% %%% % %
%     % % %   %       % %     % % %     % %       %   %     %     % % % %       %
%%% % %%%%%%% %%% %%%%% % % % % % % %%% % % %%% %%% %%%%% %%% % % %%%%% %%% % % %
%   % %       %     % %   % %   %     % %     % % %   %   %   % %     %     % % %
% %%% %%%%% %%%%% %%% %%% %%% %%% %%%%% % %%% %%% % % % %%%%% %%%%%%%%% % %%%%%%%
%   % % %           % %     %   %     % %   % %     %     %   %         %     % %
% %%%%% % %%% %%%%% % %%% %%%%% %%% %%%%%%%%%%%%% %%%%%%% % %%% %%% % % %%% % % %
% %   %   % %   %     %     %       %     %     %   % %   % % %   % % % %   %   %
% %%% %%%%% %%%%% %%%%% % %%%%% % %%% %%%%% %%% % % % %%% % % % %%% %%%%% %%% % %
%   %   %     %   %   % % % %   %     % % %   %   % %         %   % %   %   % % %
% %%%%% %%% % % %%%%% %%% % %%%%% %%%%% % % %%% %%% % %%% %%% % % % %%% %%%%%%% %
%           %   %     % %   % %     %     % % % %   %   %   % % % % %       % % %
%%% % % %%%%%%%%%%% % % %%%%% %%% %%% %%%%%%% %%% %%%%%%%%%%% % %%%%%%%%% %%% % %
% % % %     %     % %   %   %         %     %   % %   %       %       %       % %
% % % %%%%%%%%%%% % %%% % %%%%% %%%%%%%%%%% %%% % % %%%%% % %%% %%%%% %%% %%%%% %
% % %     % %   %     %   % %       % %       %     %   % %   %   % %   %   %   %
% %%%%%%% % %%% %%%%%%% %%% % %%%%% % % %%% %%%%% % % % % % % % % % %%% % %%% % %
%             %   %   %   %   % % % %   %   %   % % % % % % %   %   %     % % % %
% % %%% % %%% %%% %%% %%% %%% % % %%%%%%% % % %%% % %%% % % %%%%% %%%%% %%% % %%%
% % %   % %               % % % %       % %     % %   % % % % % %   %   %   % % %
% % %%% %%%%% %%%%% %%% %%% %%% %%%%%%% % %%% % %%% % % %%% % % % %%%%% % %%% % %
% % %   %   %   %   % % %       % %     % % % %   % %   % % %     % % % %       %
%%% %%% % %%% %%% % % %%%%%%% % % %%%%% % % % %%%%%%% %%% %%%%%%%%% % %%% %%% %%%
%   %   %     % % %     %     %       %   %     % %       % %         % % % %   %
% %%%%%%% %%%%% % %%% % % %%% %%% %%%%%%% % %%% % % % % %%% % %%% % %%% %%% %%% %
%     %     % % %   % %   % % %       %   %   %     % %   % % % % % % %         %
% % % %%% %%% % %%% %%%%% % %%%%% % % %%% %%%%%%% %%%%%%% % % % %%%%% % %%% %%%%%
%.% %   %         %   %     %     % % %   %           %             %   %       %
%%%%%%%%%%%%%%%%%%%%%%%%%%%%%%%%%%%%%%%%%%%%%%%%%%%%%%%%%%%%%%%%%%%%%%%%%%%%%%%%% 