%%%%%%%%%%%%%%%%%%%%%%%%%%%%%%%%%%%%%%%%%%%%%%%%%%%%%%%%%%%%%%%%%%%%%%%%%%%%%%%%%%%%%%%%%%%
%P  %   %     %   % % % %       % %     %   %               %         %         %         %
% %%% %%% % %%% % % % % % % %%%%% %%% % %%% % %%% %%%%% %%%%%%% % % %%%%% %%%%% % %%%%% %%%
%         %   % % %   % % %   % %   % % %   % %   % %           % %   %   % %   %   %     %
%%%%% %%%%% % % %%% % % %%% %%% % %%%%% %%% %%%%% % % %%% %%%%%%%%%%%%%%% % % %%% % % %%% %
%   % %     %   %   %         %     % % %       % %   % %         %   % % %       % % %   %
% %%%%%%%%% %%% % %%% %%% %%%%% %%% % % %%%%% %%% %%% % %%%%%%%%%%% %%% %%%%%%% %%% %%% % %
%   %   %   %       %   %     % % % %         % % % %                         %   % %   % %
% % %%% %%%%%%%%% % % % % % %%% % %%% %%%%% %%% %%% %%%%% %%%%%%% %%% % %%% % % % %%%%%%%%%
% %               % % % % %   %           % %   % %     % %     % %   % % % %   %   %     %
% %%%%%%%%%%%%%%%%%%%%% % % %%% %%% %%%%%%% % %%% % % %%% % %%%%%%% %%% % %%%%%%% %%%%% % %
%     % %       % %     % %   % %     %   %         % % % %   %       % %     % % %   % % %
% %%% % % %%%%% % %%%%%%%%% % % % %%%%%%% % %%%%% %%%%% % % % %%%%% %%%%%%% %%% %%% %%%%% %
%   %       %   % %   % %   %   %     %     % %     %       % % %       %     % %   %     %
%%%%%%%%%%%%% %%% % % % %%%%% %%%%%%%%%%%%%%% %%% %%%%% %%% %%% % % %%%%%%% % % % %%% % %%%
% %   %   % %   % % % %         % %   %   % %       %   % % %   % %     %   %         %   %
% %%% % %%% % % % % % % %%%%% %%% % %%% %%% % %%%%%%%%% % %%% %%%%%%% % %%%%% % %%% %%%%%%%
% %   %     % % %   % % %   %       %       %     %         %     % % % %     % %       % %
% %%% %%% % %%%%% %%%%% %%% %%% %%%%%%%%% %%% %%%%%%% %%%%% %%%%% % % %%% %%% %%% %%% %%% %
%         %   % %     % %       % %   %   % %         %     %           % %     %   %   % %
% %%% % %%% %%% % %%%%%%% %%%%% % %%% % %%% %%%%%%%%% %%% %%%%%%% % %%%%%%%%%%% %%%%% % % %
% %   %   %             % % % % %   %   % %         %   %   % %   % %     %   %   %   %   %
%%%%%%% % % %%%%% % %%%%% % % % %%% % % % %%%%% %%% % %%%%% % % %%%%%%%%% %%% % %%%%% %%% %
% %   % % %     % % %   % %   %   %   %     % %   %   % %     % %               % %   % % %
% % %%%%% %%% %%%%%%% %%% % %%%%%%% %%%%%%%%% %%%%%%% % % % %%%%% %%%%% %%%%%%% % %%%%% % %
%       % %         % % %     %           %         % %   %   %   %     %   %           % %
%%%%% %%%%%%%%% % % % % %%%%%%%%% % %%% %%%%%%%%% %%% %%%%%%%%% % %%%%%%% %%%%%%%%% %%%%%%%
%   %       %   % % % % % % % %   % % %   %             % % % % %   %     %   % %     %   %
%%% %%% % %%% % % %%% % % % % %%% %%% % % % %%%%%%% %%%%% % % %%%%% %%% %%% % % %%% %%%%% %
%     % %     % % %     % % %   %     % % %   %       %         %       %   %     % % % % %
% % % %%%%% %%% %%%%% % % % % % % %%%%%%%%%%% %%%%% %%%%% %%% %%%%% %%% % % % % %%% % % % %
% % %   %   %   % %   %   % % %       %       % %   % % % % %     % % % % % % %       %   %
% %%%%% %%% % % % %%% % %%% % %%%%%%% % %%% %%% %%% % % %%% % %%% %%% % % % % %%% % %%% %%%
%   %       % %     % %     % %   %       % % %       % % % % %       % % % % %   %       %
% %%% %%% %%% %%%%% %%%%% %%% %%% % %%% % %%% % %%% %%% % % %%% %%% % %%%%%%%%%%%%% %%%%% %
%   %   % %     % % % % %       %   % % %     % % %   %   %   % % % %         %   % %     %
% % %%% %%% %%%%% % % % % % %%%%%%%%% %%% %%% % % % % % % %%% % % % % %%%%%%%%% % %%% % %%%
% %   % %   %       %     % %         %     % %   % % % %       % % % %       % %   % %   %
%%%%% % % %%%%%%% %%%%% %%%%%%% %%% %%%%% %%%%% %%% %%%%% %%% % % % %%% %%% %%% % %%% % %%%
% % % % % %                       %   %   % % % % % %       % % %   % % % %   % %   % %   %
% % %%% %%% % %%%%% %%%%% % %%%%% %%%%% %%% % % % % % %%%%% %%% %%% % %%% % % % %%% %%% %%%
%   % %   % %     % % %   %   %       % % %     % %       %   % %     %     % %   %       %
% % % %%%%%%% %%%%%%% %%% %%% %%% %%%%%%% %%%%%%% %%%%% %%% %%% %%%%% %%%%% %%%%%%% %%%%%%%
% % % %       %     %       %   %   %   %   %   %     % % %   % %     %     %   %   %     %
%%% % %%%%% %%% %%% % % %%%%% % % %%% %%% %%% % % % % % % %%%%%%% %%%%% % %%% %%%%% %%%%% %
%   %   % %     % % % % %   % % % % %       % %   % %           % %   % % %         % %   %
%%% % %%% % % %%% %%%%% % %%% %%%%% % %%% %%%%%%%%%%% %%%%%%%%%%% % % % % %%%%%%% % % %%% %
%   %   % % %   %   %   %   %     % %   %   %     %   %   %     %   %   %       % %       %
% % %%% % % %%%%%%% % %%% % % %%%%% % %%%%%%% %%% % % % %%%%% % %%% %%%%%%%%% % % %%% % %%%
% % %   %       % % %   % %   %   % %     % %   %   %         %   %     %   % %     % %   %
% %%% %%%%% % %%% % %%%%%%%%% % % % %%%%% % %%%%%%%%% % % %%% % %%%%%%% %%% % %%%%%%% % % %
% %       % %     %       %   % % % %     % % %     % % %   % % % % % % %         %   % % %
% %%% %%%%% %%%%% % %%% %%% %%% %%% % %%%%% % % %%%%% % %%%%%%%%% % % % %%%%% %%%%% % %%% %
% %           %       % % %   % % %     %   %     %   % %     %     %     %     %   % % % %
% % %%% % %%% %%%%%%%%%%% % %%% % % %%%%%%% %%%%% %%%%% % %%%%%%%%% % %%%%% % %%%%%%% % %%%
%     % %   %     %     %         % % %   %   %   % %       % %     % %     %   %   % %   %
% %%%%%%%%%%%%%%% % %%%%% %%% %%% % % %%% % %%% % % %%%%%%%%% % % % %%% %%%%%%%%% %%% %%% %
% % % %           %   % %   % %       % %       %     %   %     % %           %   %   %   %
% % % %%%%%%%%%%%%% %%% % %%%%%%%%% % % % % %%%%% %%%%% %%%%% %%% %%%%% % % % % %%%%% % % %
%           %       % % % %       % % %   % % %         % %   %     % % % % % %   %   % % %
%%%%% %%%%% %%% %%% % % %%%%% %%% % %%% %%%%% %%% % %%%%% % % %%%%%%% %%%%%%%%% %%%%% %%% %
%     % % %   % % %     % %   %   %       %   %   % %   %   %   % %     % % % %         % %
% %%%%% % % %%%%% % %%%%% % % %%% % %%%%% %%% %%%%% % %%%%%%%%%%% %%%%% % % % %%%%%%% %%% %
%     % %   %     % %   % % % %   % % %   % % % %   %     %   %   % % % %     %         % %
% % %%% %%% %%% %%% %%% % %%%%% % %%% %%%%% % % %%%%% % %%%%% % % % % % % % %%% %%% % % % %
% % %   % % %   % % %           %       % %   % %     %   % %   %   %     %     %   % %   %
% % % % % %%% %%% % % %%% %%%%%%%%% %%% % % %%% %%%%%%% %%% %%% %%% % % %%% %%%%%%% % % % %
% % % %         % %     %   %   %   %   % %           % %   % % % %   % % % %       % % % %
% %%% %%% %%% %%% % %%%%%%%%%%% % %%% % % % % %%%%% % % %%% % % % % % %%% %%% %%%%% %%%%% %
% % % %   % % %   % % %     % % % % % %     %   %   %         % % % %       % % % %   % % %
% % %%% %%% %%%%% % % % %%% % % %%% % % %%% % %%%%% %%%%%%%%%%%%% %%% % % %%%%% % % %%% % %
%         %   %     %   % %   % %     %   % %     %   %   %     %     % %   %         % % %
%%%%% % % % % %%%%% %%%%% % %%% % % %%%%% %%% % % %%%%% % % %%% %%%%% % % %%%%%%%%% %%% %%%
% %   % % % % %   % %   %   %   % %   % %   % % %     % %   %     % % % % %     %       % %
% % %%%%%%% % % % %%%%% % % %%% %%%%% % % %%% %%%%% % %%% %%%%%%%%% % %%%%% % % %%%%% %%% %
% %   % %   %   % % %     %   % % %   % %   % %     % %   %   % %     %     % %   % %   % %
% % %%% % % % %%% % %%% %%% %%% % %%%%% % %%% %%%%% %%%%% %%% % %%%%% % % %%% %%% % % %%% %
%         % % %         % % %     % %     %     %             %   % % % % %   %   %   %   %
%%% % % % %%% %%% %%% % % %%% % % % % % % %%% % % %%%%%%% %%%%%%% % % % %%% % %%%%%%%%%%% %
% % % % % % % %     % %     % % %   % % %   % % % %   %   %   % % %   % %   % %   %       %
% % % %%%%% %%%%%%%%% % %%%%%%%%%%% %%%%% % %%%%%%%%% % % %%% % % %%%%%%% % %%% % %%% % % %
%   % %   % %   %   % %     % %       %   %   %   %   % %           %   % %   % %     % % %
%%%%% %%% % % % % %%%%% % %%% % % %%%%%%%%%%%%% %%% % %%% %%% %%% %%%%% %%%%% % % % %%%%% %
% %     % %   % %   %   %     % % % % %   %       % % %   % % % %   % %   %     % %     % %
% % % %%% % %%% % % %%% % %%%%% % % % %%% % % % %%% % %%% % %%% % %%% %%% %%% %%%%%%%%%%% %
% % %         % % %   % %   %   %       % % % %     %   %   %     %     % %   %   % % %   %
% %%%%% %%%%% % %%%%% %%% % %%% %%%%%%% % % % %%%%%%%%%%% %%%%% %%% % % % % %%%%% % % % %%%
%     %     % %     %     %     %     %   % %     %     %   %     % % %         % %       %
% % %%% % % %%%%% %%%%% %%%%%%% %%%%% % % % %%%%% % % %%% % %%%%% %%%%%%% % %%% % %%%%% %%%
%.%     % %   %     %         % %       %     %     %     %   %           %   %       %   %
%%%%%%%%%%%%%%%%%%%%%%%%%%%%%%%%%%%%%%%%%%%%%%%%%%%%%%%%%%%%%%%%%%%%%%%%%%%%%%%%%%%%%%%%%%% 