%%%%%%%%%%%%%%%%%%%%%%%%%%%%%%%%%%%%%%%%%%%%%%%%%%%%%%%%%%%%%%%%%%%%%%%
%         %           %     %         % %           %     %           %
% %%% %%%%%%%%%%%%% %%% %%%%% %%% %%% % %%%%% %%% %%%%%%% %%% %%% % %%%
%   %   % % %           %       %   %     %     % %           %   %   %
%%% %%%%% % %%%%%%%%% %%%%% % % %%%%% % % % % % %%% % %%%%% % %%% %%% %
% %           % %   % % %   % % % %   % % % % %     % % %   % %     % %
% %%% %%%%% %%% % %%% % % %%% %%% %%%%% %%%%%%%%%%% % % %%% %%% %%% %%%
%       %       %       % % %   % % %   % %   %     %     % % % %   % %
% %%% %%%%%%%%%%% %%%%% %%% % % % % %%% % % %%% %%%%%%%%%%% % %%%%% % %
% % % % % %   %   % % %       %     % % %   %     % % % % %       %   %
% % % % % % %%%%%%% % %%% % %%%%%%%%% % % %%% %%% % % % % % % %%%%% %%%
% %           %     %   % %   % % %     % %   %     %       % %   % % %
% %%%%%%% % %%% %%%%%%% % %%%%% % % %%%%% %%% %%%%% %%% % %%%%%%% % % %
%   % %   %         % %       % %     %     % % % % % % %   %   %   % %
% % % %%% %%%%%%%%% % % %%% %%% %%%%%%% %%% %%% % %%% % % %%%%% %%% % %
% %     % %   %   % % %   %   %   %   % %     %       % % %   % %     %
% %%%%%%% % % % %%% % % %%%%%%% %%% % % %%%%%%% %%%%%%% %%%%% % % %%% %
%   % %     % %   % %         %   % %       %     %   %     % % %   % %
%%% % %%%%%%%%% % % %%% % %%% %%% %%% %%%%% %%% % % %%%%% %%% % %%% %%%
%       % %     % %   % % % %     %       %     % %   %   %       %   %
%%% %%%%% % %%% %%% %%%%% % % % %%%%%%%%% %%%%% %%% % %%%%% %%%%% % % %
%     %     %         % % %   % %       %   %     % % % %     % %   % %
% %%%%% % % %%% %%% % % % %%%%% % % % %%% %%% %%% % % % %%%%% % %%% %%%
% %     % % %     % %     %   %   % %     % % %   % %   %     % % %   %
%%%%% % %%%%% % % % % %%% % % %%%%% %%%%%%% %%% %%% %%% %%%%% % % %%%%%
%     % %     % % % %   %   % % %   %     %   %       %   %   %   %   %
% %%% %%% % % %%%%% % % %%% %%% % %%%%%%% % % %%% % %%% %%%%% %%% % %%%
% %     % % % %     % % % % % % %   % % %   %     % %       % % % %   %
%%% % % % % % %%%%% %%%%% % % % % % % % % %%%%% %%% %%% %%% % % % % %%%
% % % % % % %   %   %       % % % % %   % %       % % %   %       % % %
% %%% %%%%%%%%%%% %%% %%% %%% % %%%%% %%% % %%%%% %%% % % %%%%% % % % %
%     %   % %     %   % % % % %           %     % %     %   %   %     %
% %%%%% %%% % % %%%%%%% % % % % % % %%%%% %%%%% %%% % % %%% %%% %%%%%%%
%   %   %   % %   %     % %   % % % %   %     % %   % %   %   % %   % %
% %%% % % %%%%% %%% %%% % % %%%%%%%%%%% %%% % %%% % %%%%%%% % %%%%% % %
%   % %     % % %     %   %       % %       %   % %   %     % %   % % %
% %%% %%% % % % %%%%%%%%%%% %%%%%%% %%%%% % %%%%% % %%% %%% % % % % % %
%   %   % % %     % % %       %       %   %     % % % %   % % % %   % %
%%% %%% %%%%% %%% % % % %%% %%% %%%%% % %%%%% %%%%% % % %%%%%%%%% %%% %
% % %           %   %   %     % % % %       %     %   %           % % %
% % % % %%% %%% % %%%%% % %%%%% % % %%%%%%% % % % %%%%% % %%%%%%% % % %
% % % %   % %   % %     %   %   %     %     % % % %   % % % %         %
% %%% % %%% %%%%% %%% %%%%%%% % %%% %%%%% % %%%%% %%% %%%%% %%% %%%%%%%
% % % % %   % %   % %       % %         % % %     % %       % %   %   %
% % %%%%% % % %%% % % % %%%%%%%%% %%% %%%%% % %%% % % %%%%% % % %%%%% %
%   %     %   % %   % %   %       % %     % % %     %     % % % % % % %
% % %%% % % % % %%% %%% %%%%% %%%%% % % %%% %%%%% %%% %%%%%%% % % % % %
% % %   % % % %         %           % % % %   % %     % %     % % %   %
% % %%% % %%%%% %%%%%%%%%%% %%%%% % %%%%% %%%%% % %%% % % %%%%%%% % % %
% %     % %     % %       %   %   %       % %   % % % %   % % % %   % %
% %%%%%%% % %%%%% % % %%% % % %%%%% % % % % %%% %%% %%%%% % % % %%% % %
% %     % %   %   % % %   % % %   % % % %     %     % %   %     %   % %
%%%%% %%% % %%% %%%%%%%%% % % % %%%%% %%%%%%%%%%% %%% % % %%%%% %%%%% %
%   %     % % %   %       % %   %   %               %   %     % % % % %
%%% %%%%% %%% % %%%%%%%%% % %%%%%%% %%% % % % %%%%% % %%%%% % % % % % %
%     %   %               % %     %   % % % % %     % %     %         %
%%%%% %%%%% %%%%% %%%%%%% % %%% %%% % %%%%%%%%% % % % % %%%%%%% %%%%% %
% %     % %   %       % %   %       %   %       % %   % %     %     % %
% % % % % % %%% %%% %%% %%%%%%%%%%%%% %%%%% % % %%% %%%%% %%% %%% % %%%
%   % %     %   %   %   %         % %     % % %   %     % %   %   %   %
%%%%%%% %%%%% %%%%% %%% % %%% % %%% % %%% %%% %%%%%%%%% %%%%% %%% %%% %
%   % %     %   %     %     % %   %     %       %     % %         % % %
%%% % %%% %%%%%%%%% %%%%% %%%%% % %%%%% %%% %%% % % %%%%%%%%%%%%%%% % %
%   %     % %     % %   %     % %       %     % % %       %       %   %
%%% %%%%%%% % %%%%% %%% % %%% % % %%%%% %%% %%% % %%% % % %%%%%%% %%% %
% %     %     %     % %   %   % %   %   %     % %   % % %       %   % %
% %%% % % %%% % %%% % % % %%% % % %%%%%%%%%%% %%% %%%%%%%%%%%%%%%%% % %
%     % %   %   %   %   %   % % % %     %   %       %   % % % %   % % %
% %%% %%% %%%%%%% %%%%%%%%%%% % % % % %%%%% %%%%% % %%% % % % % %%% % %
%.%           %       %       % %   %       %     %     %            P%
%%%%%%%%%%%%%%%%%%%%%%%%%%%%%%%%%%%%%%%%%%%%%%%%%%%%%%%%%%%%%%%%%%%%%%% 