%%%%%%%%%%%
%   % %   %
% %%% % % %
%       % %
% %%% % %%%
%   % %   %
%%% % %%% %
% % % % % %
% % % % % %
%.  % %  P%
%%%%%%%%%%% 