%%%%%%%%%%%%%%%%%%%%
%.           ...P  %
%.%%.%%.%%.%%.%% % %
% %% %           % %
%%%%%%%%%%%%%%%%%%%%
