%%%%%%%
%    .%
% %%% %
%  %  %
%%   %%
%P %%%%
%%%%%%%
